   66   145   225    46    68   144   160    46    47    47    48    48    48    49    49    49    49    50    50    50    50    50    51    51    51    51    51    51    52    52    52    52    52    52    52    53    53    53    53    53    53    53    53    54    54    54    54    54    54    54    54    54    54    55    55    55    55    55    55    55    55    55    55    55    56    56    56    56    56    56    56    56    56    56    56    56    57    57    57    57    57    57    57    57    57    57    57    57    57    57    57    57    57    58    58    58    58    58    58    58    58    58    58    58    58    58    58    58    58    59    59    59    59    59    59    59    59    59    59    59    59    59    59    59    60    60    60    60    60    60    60    60    60    60    60    60    60    60    61    61    61    61    61    61    61    61    61    61    61    61    61    61    62    62    62    62    62    62    62    62    62    62    62    62    62    63    63    63    63    63    63    63    63    63    63    63    63    63    64    64    64    64    64    64    64    64    64    64    64    64    65    65    65    65    65    65    65    65    65    65    65    66    66    66    66    66    66    66    66    66    66    66    67    67    67    67    67    67    67    67    67    67    68    68    68    68    68    68    68    68    68    68   155   154   155   153   154   155   152   153   154   155   151   152   153   154   155   150   151   152   153   154   155   149   150   151   152   153   154   155   148   149   150   151   152   153   154   155   146   147   148   149   150   151   152   153   154   155   145   146   147   148   149   150   151   152   153   154   155   144   145   146   147   148   149   150   151   152   153   154   155   144   145   146   147   148   149   150   151   152   153   154   155   156   157   158   159   160   144   145   146   147   148   149   150   151   152   153   154   155   156   157   158   159   144   145   146   147   148   149   150   151   152   153   154   155   156   157   158   144   145   146   147   148   149   150   151   152   153   154   155   156   157   144   145   146   147   148   149   150   151   152   153   154   155   156   157   144   145   146   147   148   149   150   151   152   153   154   155   156   144   145   146   147   148   149   150   151   152   153   154   155   156   144   145   146   147   148   149   150   151   152   153   154   155   144   145   146   147   148   149   150   151   152   153   154   144   145   146   147   148   149   150   151   152   153   154   144   145   146   147   148   149   150   151   152   153   144   145   146   147   148   149   150   151   152   153     0     0     0     0     0     0     0     0     0     0     0     0     0     0     0     0     0     0     0     0     0     0     0     0     0     0     0     0     0     0     0     0     0     0     0     0     0     0     0     0     0     0     0
   77   117   158    66    86   116   127    66    67    67    67    68    68    68    68    68    69    69    69    69    69    69    69    70    70    70    70    70    70    70    70    70    71    71    71    71    71    71    71    71    71    71    71    72    72    72    72    72    72    72    72    72    72    72    72    73    73    73    73    73    73    73    73    73    73    73    73    74    74    74    74    74    74    74    74    74    74    74    74    75    75    75    75    75    75    75    75    75    75    75    75    76    76    76    76    76    76    76    76    76    76    76    76    77    77    77    77    77    77    77    77    77    77    77    78    78    78    78    78    78    78    78    78    78    79    79    79    79    79    79    79    79    79    80    80    80    80    80    80    80    80    81    81    81    81    81    81    81    82    82    82    82    82    82    83    83    83    83    83    84    84    84    85    85    86   127   125   126   127   123   124   125   126   127   121   122   123   124   125   126   127   119   120   121   122   123   124   125   126   127   117   118   119   120   121   122   123   124   125   126   127   116   117   118   119   120   121   122   123   124   125   126   127   116   117   118   119   120   121   122   123   124   125   126   127   116   117   118   119   120   121   122   123   124   125   126   127   116   117   118   119   120   121   122   123   124   125   126   127   116   117   118   119   120   121   122   123   124   125   126   127   116   117   118   119   120   121   122   123   124   125   126   116   117   118   119   120   121   122   123   124   125   116   117   118   119   120   121   122   123   124   116   117   118   119   120   121   122   123   116   117   118   119   120   121   122   116   117   118   119   120   121   116   117   118   119   120   116   117   118   116   117   116     0     0     0     0     0     0     0     0     0     0     0     0     0     0     0     0     0     0     0     0     0     0     0     0     0     0     0     0     0     0     0     0     0     0     0     0     0     0     0     0     0     0     0     0     0     0     0     0     0     0     0     0     0     0     0     0     0     0     0     0     0     0     0     0     0     0     0     0     0     0     0     0     0     0     0     0     0     0     0     0     0     0     0     0     0     0     0     0     0     0     0     0     0     0     0     0     0     0     0     0     0     0     0     0     0     0     0     0     0     0     0     0     0     0     0     0     0     0     0     0     0     0     0     0     0     0     0     0     0     0     0     0     0     0     0     0     0     0     0     0     0     0     0     0     0     0     0     0     0     0     0     0     0     0     0     0     0     0     0     0     0     0     0     0     0     0     0     0     0     0     0     0     0     0     0     0     0
  109   132   154    99   110   123   141    99    99    99    99    99    99    99    99    99    99    99   100   100   100   100   100   100   100   100   100   100   100   101   101   101   101   101   101   101   101   101   101   101   102   102   102   102   102   102   102   102   102   102   102   102   103   103   103   103   103   103   103   103   103   103   103   103   104   104   104   104   104   104   104   104   104   104   104   104   105   105   105   105   105   105   105   105   105   105   105   105   105   106   106   106   106   106   106   106   106   106   106   106   106   106   107   107   107   107   107   107   107   107   107   107   107   107   107   107   108   108   108   108   108   108   108   108   108   108   108   108   108   108   109   109   109   109   109   109   109   109   109   109   109   109   109   109   109   109   110   110   110   110   110   110   110   110   110   110   110   110   110   110   110   131   132   133   134   135   136   137   138   139   140   141   131   132   133   134   135   136   137   138   139   140   141   130   131   132   133   134   135   136   137   138   139   140   129   130   131   132   133   134   135   136   137   138   139   140   129   130   131   132   133   134   135   136   137   138   139   140   128   129   130   131   132   133   134   135   136   137   138   139   127   128   129   130   131   132   133   134   135   136   137   138   139   127   128   129   130   131   132   133   134   135   136   137   138   139   125   126   127   128   129   130   131   132   133   134   135   136   137   138   125   126   127   128   129   130   131   132   133   134   135   136   137   138   123   124   125   126   127   128   129   130   131   132   133   134   135   136   137   138   123   124   125   126   127   128   129   130   131   132   133   134   135   136   137     0     0     0     0     0     0     0     0     0     0     0     0     0     0     0     0     0     0     0     0     0     0     0     0     0     0     0     0     0     0     0     0     0     0     0     0     0     0     0     0     0     0     0     0     0     0     0     0     0     0     0     0     0     0     0     0     0     0     0     0     0     0     0     0     0     0     0     0     0     0     0     0     0     0     0     0     0     0     0     0     0     0     0     0     0     0     0     0     0     0     0     0     0     0     0     0     0     0     0     0     0     0     0     0     0     0     0     0     0     0     0     0     0     0     0     0     0     0     0     0     0     0     0     0     0     0     0     0     0     0     0     0     0     0     0     0     0     0     0     0     0     0     0     0     0     0     0     0     0     0     0     0     0     0     0     0     0     0     0     0     0     0     0     0     0     0     0     0     0     0     0     0     0     0     0     0     0     0     0     0     0     0     0     0     0
   67    76   112    61    76    75    86    61    61    61    61    62    62    62    62    63    63    63    63    63    64    64    64    64    64    65    65    65    65    65    65    66    66    66    66    66    66    66    67    67    67    67    67    67    67    68    68    68    68    68    68    68    68    69    69    69    69    69    69    69    69    69    70    70    70    70    70    70    70    70    70    70    71    71    71    71    71    71    71    71    71    71    71    71    72    72    72    72    72    72    72    72    72    72    72    73    73    73    73    73    73    73    73    73    74    74    74    74    74    74    74    74    75    75    75    75    75    76    76    75    76    77    78    75    76    77    78    75    76    77    78    79    75    76    77    78    79    75    76    77    78    79    80    75    76    77    78    79    80    81    75    76    77    78    79    80    81    75    76    77    78    79    80    81    82    75    76    77    78    79    80    81    82    83    75    76    77    78    79    80    81    82    83    84    75    76    77    78    79    80    81    82    83    84    85    86    76    77    78    79    80    81    82    83    84    85    86    78    79    80    81    82    83    84    85    86    79    80    81    82    83    84    85    86    82    83    84    85    86    85    86     0     0     0     0     0     0     0     0     0     0     0     0     0     0     0     0     0     0     0     0     0     0     0     0     0     0     0     0     0     0     0     0     0     0     0     0     0     0     0     0     0     0     0     0     0     0     0     0     0     0     0     0     0     0     0     0     0     0     0     0     0     0     0     0     0     0     0     0     0     0     0     0     0     0     0     0     0     0     0     0     0     0     0     0     0     0     0     0     0     0     0     0     0     0     0     0     0     0     0     0     0     0     0     0     0     0     0     0     0     0     0     0     0     0     0     0     0     0     0     0     0     0     0     0     0     0     0     0     0     0     0     0     0     0     0     0     0     0     0     0     0     0     0     0     0     0     0     0     0     0     0     0     0     0     0     0     0     0     0     0     0     0     0     0     0     0     0     0     0     0     0     0     0     0     0     0     0     0     0     0     0     0     0     0     0     0     0     0     0     0     0     0     0     0     0     0     0     0     0     0     0     0     0     0     0     0     0     0     0     0     0     0     0     0     0     0     0     0     0     0     0     0     0     0     0     0     0     0     0     0     0     0     0     0     0     0     0     0     0     0     0     0     0     0     0     0     0     0     0     0     0     0     0     0     0     0     0     0     0     0     0     0     0     0     0     0     0     0     0
  138   150    95   128   139   140   154   128   128   128   128   128   128   128   128   129   129   129   129   129   129   129   129   130   130   130   130   130   130   130   130   131   131   131   131   131   131   131   131   132   132   132   132   132   132   132   132   133   133   133   133   133   133   133   133   134   134   134   134   134   134   134   134   135   135   135   135   135   135   135   135   136   136   136   136   136   136   136   137   137   137   137   137   137   137   137   138   138   138   138   138   138   138   138   139   139   139   139   139   139   139   139   140   141   142   143   144   145   146   147   140   141   142   143   144   145   146   147   141   142   143   144   145   146   147   148   142   143   144   145   146   147   148   149   143   144   145   146   147   148   149   150   143   144   145   146   147   148   149   150   144   145   146   147   148   149   150   151   145   146   147   148   149   150   151   152   146   147   148   149   150   151   152   146   147   148   149   150   151   152   153   146   147   148   149   150   151   152   153   147   148   149   150   151   152   153   154     0     0     0     0     0     0     0     0     0     0     0     0     0     0     0     0     0     0     0     0     0     0     0     0     0     0     0     0     0     0     0     0     0     0     0     0     0     0     0     0     0     0     0     0     0     0     0     0     0     0     0     0     0     0     0     0     0     0     0     0     0     0     0     0     0     0     0     0     0     0     0     0     0     0     0     0     0     0     0     0     0     0     0     0     0     0     0     0     0     0     0     0     0     0     0     0     0     0     0     0     0     0     0     0     0     0     0     0     0     0     0     0     0     0     0     0     0     0     0     0     0     0     0     0     0     0     0     0     0     0     0     0     0     0     0     0     0     0     0     0     0     0     0     0     0     0     0     0     0     0     0     0     0     0     0     0     0     0     0     0     0     0     0     0     0     0     0     0     0     0     0     0     0     0     0     0     0     0     0     0     0     0     0     0     0     0     0     0     0     0     0     0     0     0     0     0     0     0     0     0     0     0     0     0     0     0     0     0     0     0     0     0     0     0     0     0     0     0     0     0     0     0     0     0     0     0     0     0     0     0     0     0     0     0     0     0     0     0     0     0     0     0     0     0     0     0     0     0     0     0     0     0     0     0     0     0     0     0     0     0     0     0     0     0     0     0     0     0     0     0     0     0     0     0     0     0     0     0     0     0     0     0     0     0     0     0     0     0     0     0     0     0     0     0     0     0     0     0     0     0     0     0     0
   81    65    63    77    85    64    75    77    78    78    78    79    79    79    79    79    79    79    80    80    80    80    80    80    80    80    80    80    80    80    81    81    81    81    81    81    81    81    81    81    81    81    82    82    82    82    82    82    82    82    82    82    82    82    83    83    83    83    83    83    83    83    83    83    83    83    84    84    84    85    64    64    65    66    64    65    66    67    68    69    70    64    65    66    67    68    69    70    71    72    73    74    75    64    65    66    67    68    69    70    71    72    73    74    75    64    65    66    67    68    69    70    71    72    73    74    75    64    65    66    67    68    69    70    71    72    73    74    75    64    65    75    64     0     0     0     0     0     0     0     0     0     0     0     0     0     0     0     0     0     0     0     0     0     0     0     0     0     0     0     0     0     0     0     0     0     0     0     0     0     0     0     0     0     0     0     0     0     0     0     0     0     0     0     0     0     0     0     0     0     0     0     0     0     0     0     0     0     0     0     0     0     0     0     0     0     0     0     0     0     0     0     0     0     0     0     0     0     0     0     0     0     0     0     0     0     0     0     0     0     0     0     0     0     0     0     0     0     0     0     0     0     0     0     0     0     0     0     0     0     0     0     0     0     0     0     0     0     0     0     0     0     0     0     0     0     0     0     0     0     0     0     0     0     0     0     0     0     0     0     0     0     0     0     0     0     0     0     0     0     0     0     0     0     0     0     0     0     0     0     0     0     0     0     0     0     0     0     0     0     0     0     0     0     0     0     0     0     0     0     0     0     0     0     0     0     0     0     0     0     0     0     0     0     0     0     0     0     0     0     0     0     0     0     0     0     0     0     0     0     0     0     0     0     0     0     0     0     0     0     0     0     0     0     0     0     0     0     0     0     0     0     0     0     0     0     0     0     0     0     0     0     0     0     0     0     0     0     0     0     0     0     0     0     0     0     0     0     0     0     0     0     0     0     0     0     0     0     0     0     0     0     0     0     0     0     0     0     0     0     0     0     0     0     0     0     0     0     0     0     0     0     0     0     0     0     0     0     0     0     0     0     0     0     0     0     0     0     0     0     0     0     0     0     0     0     0     0     0     0     0     0     0     0     0     0     0     0     0     0     0     0     0     0     0     0     0     0     0     0     0     0     0     0     0     0     0     0     0     0     0     0     0     0     0     0     0     0     0     0
   51    54   108    45    63    53    64    45    46    46    47    47    47    48    48    48    48    49    49    49    49    49    49    50    50    50    50    50    50    50    51    51    51    51    51    51    51    52    52    52    52    52    52    52    52    53    53    53    53    53    53    53    53    53    54    54    54    54    54    54    54    54    54    54    55    55    55    55    55    55    55    55    55    56    56    56    56    56    56    56    56    56    57    57    57    57    57    57    57    57    58    58    58    58    58    58    58    59    59    59    59    59    59    60    60    60    60    60    61    61    61    61    62    62    63    53    53    54    53    54    55    53    54    55    56    53    54    55    56    57    58    53    54    55    56    57    58    59    53    54    55    56    57    58    59    53    54    55    56    57    58    59    60    53    54    55    56    57    58    59    60    61    53    54    55    56    57    58    59    60    61    62    55    56    57    58    59    60    61    62    63    56    57    58    59    60    61    62    63    64    57    58    59    60    61    62    63    64    58    59    60    61    62    63    64    59    60    61    62    63    64    60    61    62    63    64    61    62    63    64    63    64    64     0     0     0     0     0     0     0     0     0     0     0     0     0     0     0     0     0     0     0     0     0     0     0     0     0     0     0     0     0     0     0     0     0     0     0     0     0     0     0     0     0     0     0     0     0     0     0     0     0     0     0     0     0     0     0     0     0     0     0     0     0     0     0     0     0     0     0     0     0     0     0     0     0     0     0     0     0     0     0     0     0     0     0     0     0     0     0     0     0     0     0     0     0     0     0     0     0     0     0     0     0     0     0     0     0     0     0     0     0     0     0     0     0     0     0     0     0     0     0     0     0     0     0     0     0     0     0     0     0     0     0     0     0     0     0     0     0     0     0     0     0     0     0     0     0     0     0     0     0     0     0     0     0     0     0     0     0     0     0     0     0     0     0     0     0     0     0     0     0     0     0     0     0     0     0     0     0     0     0     0     0     0     0     0     0     0     0     0     0     0     0     0     0     0     0     0     0     0     0     0     0     0     0     0     0     0     0     0     0     0     0     0     0     0     0     0     0     0     0     0     0     0     0     0     0     0     0     0     0     0     0     0     0     0     0     0     0     0     0     0     0     0     0     0     0     0     0     0     0     0     0     0     0     0     0     0     0     0     0     0     0     0     0     0     0     0     0     0     0     0     0     0     0     0     0     0     0
   38    69    60    37    48    67    72    37    37    37    37    37    37    38    38    38    38    38    38    39    39    39    39    39    40    40    40    40    40    41    41    41    41    41    42    42    42    42    42    43    43    43    43    43    44    44    44    44    45    45    45    45    46    46    46    46    46    47    47    47    47    47    48    48    48    48    48    67    68    69    70    71    72    67    68    69    70    71    72    67    68    69    70    71    67    68    69    70    71    67    68    69    70    71    67    68    69    70    71    67    68    69    70    71    68    69    70    71    68    69    70    71    68    69    70    71    72    68    69    70    71    72    68    69    70    71    72     0     0     0     0     0     0     0     0     0     0     0     0     0     0     0     0     0     0     0     0     0     0     0     0     0     0     0     0     0     0     0     0     0     0     0     0     0     0     0     0     0     0     0     0     0     0     0     0     0     0     0     0     0     0     0     0     0     0     0     0     0     0     0     0     0     0     0     0     0     0     0     0     0     0     0     0     0     0     0     0     0     0     0     0     0     0     0     0     0     0     0     0     0     0     0     0     0     0     0     0     0     0     0     0     0     0     0     0     0     0     0     0     0     0     0     0     0     0     0     0     0     0     0     0     0     0     0     0     0     0     0     0     0     0     0     0     0     0     0     0     0     0     0     0     0     0     0     0     0     0     0     0     0     0     0     0     0     0     0     0     0     0     0     0     0     0     0     0     0     0     0     0     0     0     0     0     0     0     0     0     0     0     0     0     0     0     0     0     0     0     0     0     0     0     0     0     0     0     0     0     0     0     0     0     0     0     0     0     0     0     0     0     0     0     0     0     0     0     0     0     0     0     0     0     0     0     0     0     0     0     0     0     0     0     0     0     0     0     0     0     0     0     0     0     0     0     0     0     0     0     0     0     0     0     0     0     0     0     0     0     0     0     0     0     0     0     0     0     0     0     0     0     0     0     0     0     0     0     0     0     0     0     0     0     0     0     0     0     0     0     0     0     0     0     0     0     0     0     0     0     0     0     0     0     0     0     0     0     0     0     0     0     0     0     0     0     0     0     0     0     0     0     0     0     0     0     0     0     0     0     0     0     0     0     0     0     0     0     0     0     0     0     0     0     0     0     0     0     0     0     0     0     0     0     0     0     0     0     0     0     0     0     0     0     0     0     0     0     0     0     0     0     0
  121    57   110   106   123    56    67   106   107   107   107   108   108   108   108   109   109   109   109   109   110   110   110   110   110   110   110   111   111   111   111   111   111   111   111   112   112   112   112   112   112   112   112   113   113   113   113   113   113   113   113   114   114   114   114   114   114   114   114   115   115   115   115   115   115   115   116   116   116   116   116   116   116   117   117   117   117   117   117   117   117   118   118   118   118   118   118   118   119   119   119   119   119   119   120   120   120   120   120   120   121   121   121   121   121   121   122   122   122   122   122   122   123   123   123   123   123    67    65    66    67    64    65    66    67    63    64    65    66    67    61    62    63    64    65    66    67    60    61    62    63    64    65    66    67    60    61    62    63    64    65    66    67    59    60    61    62    63    64    65    66    58    59    60    61    62    63    64    65    58    59    60    61    62    63    64    57    58    59    60    61    62    63    56    57    58    59    60    61    62    63    56    57    58    59    60    61    62    56    57    58    59    60    61    56    57    58    59    60    61    56    57    58    59    60    61    56    57    58    59    60    61    56    57    58    59    60     0     0     0     0     0     0     0     0     0     0     0     0     0     0     0     0     0     0     0     0     0     0     0     0     0     0     0     0     0     0     0     0     0     0     0     0     0     0     0     0     0     0     0     0     0     0     0     0     0     0     0     0     0     0     0     0     0     0     0     0     0     0     0     0     0     0     0     0     0     0     0     0     0     0     0     0     0     0     0     0     0     0     0     0     0     0     0     0     0     0     0     0     0     0     0     0     0     0     0     0     0     0     0     0     0     0     0     0     0     0     0     0     0     0     0     0     0     0     0     0     0     0     0     0     0     0     0     0     0     0     0     0     0     0     0     0     0     0     0     0     0     0     0     0     0     0     0     0     0     0     0     0     0     0     0     0     0     0     0     0     0     0     0     0     0     0     0     0     0     0     0     0     0     0     0     0     0     0     0     0     0     0     0     0     0     0     0     0     0     0     0     0     0     0     0     0     0     0     0     0     0     0     0     0     0     0     0     0     0     0     0     0     0     0     0     0     0     0     0     0     0     0     0     0     0     0     0     0     0     0     0     0     0     0     0     0     0     0     0     0     0     0     0     0     0     0     0     0     0     0     0     0     0     0     0     0     0     0     0     0     0     0     0     0     0     0     0     0     0     0     0     0     0
