   68   307     3     1     1    -1     1    -1     1     0     0     0     0     0     0     0     0     0     0     0     0     0     0     0     0     0     0     0     0     0     0     0     0     0     0     0     0     0     0     0
   34   314     3    -1    -1    -1     1    -1     1     0     0     0     0     0     0     0     0     0     0     0     0     0     0     0     0     0     0     0     0     0     0     0     0     0     0     0     0     0     0     0
   46   191     4    -1     1     1    -1     1    -1    -1     1     0     0     0     0     0     0     0     0     0     0     0     0     0     0     0     0     0     0     0     0     0     0     0     0     0     0     0     0     0
   61   179     4     1    -1     1    -1     1    -1    -1     1     0     0     0     0     0     0     0     0     0     0     0     0     0     0     0     0     0     0     0     0     0     0     0     0     0     0     0     0     0
   11   245     4    -1     1    -1     1     1    -1    -1     1     0     0     0     0     0     0     0     0     0     0     0     0     0     0     0     0     0     0     0     0     0     0     0     0     0     0     0     0     0
   13   209     4     1    -1    -1     1     1    -1    -1     1     0     0     0     0     0     0     0     0     0     0     0     0     0     0     0     0     0     0     0     0     0     0     0     0     0     0     0     0     0
   17   156     5    -1     1    -1     1    -1     1    -1    -1     1    -1     0     0     0     0     0     0     0     0     0     0     0     0     0     0     0     0     0     0     0     0     0     0     0     0     0     0     0
  120    98     4    -1    -1     1    -1    -1    -1     1    -1     0     0     0     0     0     0     0     0     0     0     0     0     0     0     0     0     0     0     0     0     0     0     0     0     0     0     0     0     0
   86   104     4    -1    -1     1    -1    -1    -1     1    -1     0     0     0     0     0     0     0     0     0     0     0     0     0     0     0     0     0     0     0     0     0     0     0     0     0     0     0     0     0
  256   227     5    -1     1     1     1     1     1     1     1     1    -1     0     0     0     0     0     0     0     0     0     0     0     0     0     0     0     0     0     0     0     0     0     0     0     0     0     0     0
   52    69     5    -1    -1     1    -1    -1     1    -1    -1     1    -1     0     0     0     0     0     0     0     0     0     0     0     0     0     0     0     0     0     0     0     0     0     0     0     0     0     0     0
   16    94     5     1    -1    -1     1    -1     1    -1    -1     1    -1     0     0     0     0     0     0     0     0     0     0     0     0     0     0     0     0     0     0     0     0     0     0     0     0     0     0     0
  267   166     5     1    -1     1     1     1     1     1     1     1    -1     0     0     0     0     0     0     0     0     0     0     0     0     0     0     0     0     0     0     0     0     0     0     0     0     0     0     0
   47    48     5     1     1     1    -1    -1     1    -1    -1     1    -1     0     0     0     0     0     0     0     0     0     0     0     0     0     0     0     0     0     0     0     0     0     0     0     0     0     0     0
  146    51     5    -1     1     1     1    -1    -1     1     1     1    -1     0     0     0     0     0     0     0     0     0     0     0     0     0     0     0     0     0     0     0     0     0     0     0     0     0     0     0
   93    68     5    -1     1    -1    -1    -1    -1     1     1     1    -1     0     0     0     0     0     0     0     0     0     0     0     0     0     0     0     0     0     0     0     0     0     0     0     0     0     0     0
  202    32     5     1    -1     1     1    -1    -1     1     1     1    -1     0     0     0     0     0     0     0     0     0     0     0     0     0     0     0     0     0     0     0     0     0     0     0     0     0     0     0
  115    17     5     1    -1    -1    -1    -1    -1     1     1     1    -1     0     0     0     0     0     0     0     0     0     0     0     0     0     0     0     0     0     0     0     0     0     0     0     0     0     0     0
  242    15     5    -1    -1    -1    -1     1     1     1     1     1    -1     0     0     0     0     0     0     0     0     0     0     0     0     0     0     0     0     0     0     0     0     0     0     0     0     0     0     0
  278    64     5     1     1    -1    -1     1     1     1     1     1    -1     0     0     0     0     0     0     0     0     0     0     0     0     0     0     0     0     0     0     0     0     0     0     0     0     0     0     0
