   68   307     3    52   287    86   256   119   258     0     0     0     0     0     0     0     0     0     0     0
   34   314     3    52   287    86   256   119   258     0     0     0     0     0     0     0     0     0     0     0
   46   191     4    67   203    69   228    86   256   119   258     0     0     0     0     0     0     0     0     0
   61   179     4    67   203    69   228    86   256   119   258     0     0     0     0     0     0     0     0     0
   11   245     4    34   242    69   228    86   256   119   258     0     0     0     0     0     0     0     0     0
   13   209     4    34   242    69   228    86   256   119   258     0     0     0     0     0     0     0     0     0
   17   156     5    43   162    72   163    96   181   119   211   119   258     0     0     0     0     0     0     0
  120    98     4   114   130    96   181   119   211   119   258     0     0     0     0     0     0     0     0     0
   86   104     4   114   130    96   181   119   211   119   258     0     0     0     0     0     0     0     0     0
  256   227     5   221   205   188   184   143   193   119   211   119   258     0     0     0     0     0     0     0
   52    69     5    72   106    72   163    96   181   119   211   119   258     0     0     0     0     0     0     0
   16    94     5    43   162    72   163    96   181   119   211   119   258     0     0     0     0     0     0     0
  267   166     5   221   205   188   184   143   193   119   211   119   258     0     0     0     0     0     0     0
   47    48     5    72   106    72   163    96   181   119   211   119   258     0     0     0     0     0     0     0
  146    51     5   182    79   160   149   143   193   119   211   119   258     0     0     0     0     0     0     0
   93    68     5   137    80   160   149   143   193   119   211   119   258     0     0     0     0     0     0     0
  202    32     5   182    79   160   149   143   193   119   211   119   258     0     0     0     0     0     0     0
  115    17     5   137    80   160   149   143   193   119   211   119   258     0     0     0     0     0     0     0
  242    15     5   211    80   188   184   143   193   119   211   119   258     0     0     0     0     0     0     0
  278    64     5   211    80   188   184   143   193   119   211   119   258     0     0     0     0     0     0     0
